1111111111111111111111111111111111111111111111111111111111111111111111111111111111111111111111111111
1222222222222122222222222222222222222222222222222222222222222222222222222222222222222222222222222221
1233333333321012333333333333333333333333333333333333333333332123333333333333332333333333333333333321
1234444444432123444444434444444444444432344444444444444444321012344444444444321234444444444444444321
1234555545543234555554323455555555554321234555555555555555432123455555555543210123455555555555554321
1234565434554345666543212345666666543210123456665456666666543234566666666544321234566666666666654321
1234554323455456765432101234566567654321234567654345677777654345677777765434432345677777777777654321
1234543212345567876543212345665456765432345676543234567876765456788887654323443456778888888887654321
1234432101234567887654323456654345676543456765432123456765676567899876543212344567767899999987654321
1234543212345678998765434566543234567654567654321012345654567678998765432101234567656789101010987654321
1234554323456789101098765456654321234567656787654321234565434567891010987654321234567654567891010987654321
123456543456787891010987656654321012345676789876543234565432345678910109876543234567654345678910987654321
123456654567876789101098767765432123456787891098765434565432123456789101098765434567654323456789987654321
12345676567876567891010987887654323456567891011109876545654321012345678910109876545676543212345678987654321
1234567767876545678910109899876543456545678910111098765676543212345678910111110987656765432101234567887654321
12345678787654345678910109101098765456543456789101110987678765432345678910111212111098767876543212345678987654321
12345678876543234567891010111110987656543234567891011109878987654345678910111213131211109878987654323456789987654321
1234567876543212345678910111211109876543212345678910111098910987654567891011121314141312111098910987654345678910987654321
123456776543210123456789101110987654321012345678910111091011109876545678910111213141413121110910111098765455678910987654321
12345678765432123456789910111110987654321234567891011121110111098765434567891011121314141312111011121110987655456789987654321
123456788765432323456788910111110987654323456778910111212111098765432345678910111213141413121112121110987654345678987654321
12345678987654321234567789101111109876543456776789101111109876543212345678910111213141413121211109876543234567887654321
1234567887654321012345667891011111098765456776567891010987654321012345678910111213141312111098765432123456787654321
1234567898765432123456656789101111109876567765456789101098765432123456789101112131413121110987654321012345677654321
123456789987654323456654567891011111098767765434567891010987654323456789101112131415141312111098765432123456787654321
123456789109876543456654345678910111110987765432345678910109876543456789101112131415161514131211109876543234567887654321
12345678910109876545665432345678910111098765432123456789101098765456789101112131415161716151413121110987654345678987654321
123456789101110987656654321234567891098765432101234567891010987656789101112131415161718171615141312111098765456789987654321
123456789101111109876654321012345678910987654321234567891011111098767891011121314151617181918171615141312111098765678910987654321
12345678910111211109877654321234567891011109876543234567891011121211109878910111213141516171819201918171615141312111098767891010987654321
1234567891011121211109887654323456789101112111098765434567891011111213121110989101112131415161718192021201918171615141312111098789101110987654321
1234567891011121312111099876543456789101112111098765454567891011111011121312111091011121314151617181920212221201918171615141312111098910111110987654321
1234567891011121313121110109876545678910111211109876543456789101111109101112131211101112131415141516171819202122212019181716151413121110989101110987654321
123456789101112131413121111109876567891011121110987654323456789101098910111213121112131415141314151617181920212019181716151413121110987891010987654321
12345678910111213141413121211109876789101112111098765432123456789987891011121312131415141312131415161718192019181716151413121110987678910987654321
1234567891011121314151413121110987678910111110987654321012345678876789101112131415141312111213141516171819181716151413121110987656789987654321
1234567891011121314141312111098765678910111110987654321234567887656789101112131413121110111213141516171817161514131211109876545678987654321
123456789101112131413121110987654567891011111098765432345678876545678910111213121110910111213141516171615141312111098765434567887654321
1234567891011121313121110987654345678910111110987654345678876543456789101112111098910111213141516151413121110987654323456787654321
12345678910111213121110987654323456789101111109876545678876543234567891011109878910111213141514131211109876543212345677654321
123456789101112121110987654321234567891011111098765678876543212345678910987678910111213141312111098765432101234567654321
1234567891011121110987654321012345678910111110987678876543210123456789876567891011121314131211109876543212345677654321
1234567891011121211109876543212345678910111212111098789987654321234567898765456789101112131413121110987654323456787654321
123456789101112131211109876543234567891011121313121110989101098765432345678987654345678910111213141312111098765434567887654321
12345678910111213131211109876543456789101112131414131211109101111109876543456789876543234567891011121314131211109876545678987654321
123456789101112131413121110987654567891011121314151514131211101112121110987654567898765432123456789101112131413121110987656789987654321
123456789101112131414131211109876567891011121314151616151413121112121110910987656789876543210123456789101112131413121110987678910987654321
1234567891011121314151413121110987678910111213141516171716151413121211109891098767891098765432123456789101112131413121110987656789987654321
1234567891011121314151514131211109878910111213141516171817161514131211109878910987891011109876543234567891011121314131211109876545678987654321
1234567891011111213141515141312111098910111213141516171817161514131211109876789109891011121110987654345678910111213141312111098765434567887654321
1234567891011101112131414131211101110910111213141516171817161514131211109876567891091011121312111098765456789101112131413121110987654323456787654321
123456789101091011121313121110910111011121314151617181716151413121110987654567891011121314131211109876567891011121314131211109876543212345677654321
1234567891098910111212111098910111213141516171817161514131211109876543456789101112131413121110987678910111213141312111098765432101234567654321
1234567899878910111110987891011121314151617161514131211109876543234567891011121314131211109878910111213141514131211109876543212345677654321
12345678987678910109876789101112131415161514131211109876543212345678910111213141312111098910111213141514131211101110987654323456787654321
12345678876567899876567891011121314151413121110987654321012345678910111213141312111091011121314151413121110910111098765434567887654321
123456787654567887654567891011121314151413121110987654321234567891011121314151413121110111213141514131211109891011109876545678987654321
123456776543456776543456789101112131415141312111098765432345678910111212131415151413121112131415141312111098789101110987656789987654321
1234567654323456654323456789101112131415141312111098765434567891011121211121314151514131213141514131211109876789101110987678910987654321
123456654321234554321234567891011121314131211109876565456789101112121110111213141515141314151413121110987656789101110987891010987654321
1234565432101234432101234567891011121312111098765456567891011121211109101112131415151415141312111098765456789101110989101110987654321
123456654321234554321234567891011121312111098765434567891011121211109891011121314151514131211109876543456789101110910111110987654321
12345676543234566543234567891011121312111098765432345678910111110987891011121314141312111098765432345678910111011121110987654321
1234567765434567765434345678910111211109876543212345678910109876789101112131312111098765432123456789101112121110987654321
123456787654567887654323456789101110987654321012345678998765678910111212111098765432101234567891011121110987654321
1234567887656788765432123456789101110987654321234567899876545678910111212111098765432123456789101112121110987654321
12345678876567876543210123456789101110987654323456789987654345678910111212111098765432345678910111213121110987654321
12345678765456787654321234567891011121110987654345678998765432345678910111212111098765434567891011121313121110987654321
12345677654345678765432345678910111213121110987654567899876543212345678910111212111098765456789101112131413121110987654321
123456765432345678765434565678910111213121110987656788987654321012345678910111212111098765678910111213141413121110987654321
123456654321234567876545654567891011121312111098767887898765432123456789101112131312111098767891011121314151413121110987654321
123456543210123456787656543456789101112131211109878876789876543234567891011121314141312111098789101112131415151413121110987654321
123456654321234567898765432345678910111213121110988765678987654345678910111213141515141312111098910111213141516151413121110987654321
12345676543234567898765432123456789101112121110987654567898765456789101112131415161615141312111091011121314151616151413121110987654321
12345677654345678987654321012345678910111110987654345678987656789101112131415161717161514131211101112131415161716151413121110987654321
1234567876545678910987654321234567891011111098765432345678987678910111213141516171818171615141312111213141516171716151413121110987654321
12345678876567891011109876543234567891011111098765432123456787656789101112131415161718181716151413121314151617181716151413121110987654321
123456789876789101112111098765434567891011111098765432101234567654567891011121314151617181817161514131415161718181716151413121110987654321
123456789987889101111109876565456789101112121110987654321234567654345678910111213141516171818171615141516171819181716151413121110987654321
123456789109887891010987654565678910111213131211109876543234567654323456789101112131415161718181716151617181919181716151413121110987654321
12345678910987678998765434567891011121312131312111098765434567654321234567891011121314151617181817161718192019181716151413121110987654321
123456789987656788765432345678910111211121313121110987654567654321012345678910111213141516171818171819191919181716151413121110987654321
1234567898765456776543212345678910111011121313121110987656787654321234567891011121314151617181818181818181818181716151413121110987654321
1234567887654345665432101234567891091011121313121110987678987654323456789101112131415161717171717171717171717171716151413121110987654321
123456787654323456654321234567891098910111213131211109878910987654345678910111213141516161616161616161616161616161616151413121110987654321
12345677654321234566543234567891098789101112131312111098910109876554567891011121314151515151515151515151515151515151515151413121110987654321
123456765432101234566543456789109876789101112131312111091010987654556789101112131414141414141414141414141414141414141414141413121110987654321
12345677654321234567765456789109876567891011121313121110109876543456789101112131313131313131313131313131313131313131313131313121110987654321
12345678765432345678876567891098765456789101112121211109876543234567891011121212121212121212121212121212121212121212121212121110987654321
12345678876543455678987678910987654345678910111111109876543212345678910111111111111111111111111111111111111111111111111111110987654321
12345678987654554567898789109876543234567891010109876543210123456789101010101010101010101010101010101010101010101010101010987654321
1234567899876554345678989998765432123456789999987654321234567899999999999999999999999999999987654321
1234566788876543234567888887654321012345678888888765432345678888888888888888888888888888888887654321
1234565677765432123456777777765432123456777777777776543456777777777777777777777777777777777777654321
1234554566654321012345666666666543234566666666666666654566666666666666666666666666666666666666654321
1234543455555432123455555555555543345555555555555555555555555555555555555555555555555555555555554321
1234432344444443234444444444444432344444444444444444444444444444444444444444444444444444444444444321
1233321233333333333333333333333321233333333333333333333333333333333333333333333333333333333333333321
1222210122222222222222222222222210122222222222222222222222222222222222222222222222222222222222222221
1111111111111111111111111111111111111111111111111111111111111111111111111111111111111111111111111111
